"a" = (/turf/open/floor/rogue/dirt,/area/rogue/outdoors/bog)
"b" = (/turf/closed/mineral/rogue/bedrock,/area/rogue)
"c" = (/obj/structure/flora/roguetree,/turf/open/floor/rogue/dirt,/area/rogue/outdoors/bog)
"d" = (/turf/closed/mineral/rogue/bedrock,/area/rogue/indoors/cave)
"e" = (/turf/open/water/swamp/deep,/area/rogue/outdoors/bog)
"f" = (/obj/machinery/light/rogue/firebowl/standing/blue,/turf/open/floor/rogue/dirt/road,/area/rogue/indoors/cave)
"g" = (/turf/closed/mineral/random/rogue/high,/area/rogue/outdoors/bog)
"h" = (/turf/open/water/cleanshallow,/area/rogue/outdoors/bog)
"i" = (/turf/open/water/cleanshallow,/area/rogue/indoors/cave)
"j" = (/turf/closed/wall/mineral/rogue/craftstone,/area/rogue/outdoors/bog)
"k" = (/obj/effect/landmark/start/goblin,/turf/open/floor/rogue/dirt/road,/area/rogue/indoors/cave)
"l" = (/turf/closed/mineral/random/rogue/high,/area/rogue/indoors/cave)
"m" = (/obj/machinery/light/rogue/cauldron,/turf/open/floor/rogue/dirt/road,/area/rogue/indoors/cave)
"n" = (/obj/structure/table/wood/crafted,/obj/item/mortar,/obj/item/pestle,/turf/open/floor/rogue/dirt/road,/area/rogue/indoors/cave)
"o" = (/turf/closed/mineral/rogue/bedrock,/area/rogue/outdoors/bog)
"p" = (/obj/item/reagent_containers/glass/bucket/wooden,/turf/open/floor/rogue/dirt/road,/area/rogue/indoors/cave)
"q" = (/obj/item/grown/log/tree/stake,/turf/open/floor/rogue/dirt/road,/area/rogue/indoors/cave)
"r" = (/turf/open/floor/rogue/dirt,/area/rogue/indoors/cave)
"s" = (/obj/structure/fluff/traveltile{aportalid = "bogrt2in"; aportalgoesto = "bogrt2out"; aallmig = ""},/turf/open/floor/rogue/dirt/road,/area/rogue/outdoors/bog)
"t" = (/obj/structure/fluff/traveltile{aportalid = "bogrtin"; aportalgoesto = "bogrtout"; aallmig = ""},/turf/open/floor/rogue/dirt/road,/area/rogue/outdoors/bog)
"u" = (/obj/structure/closet/crate/chest/alchbox,/turf/open/floor/rogue/dirt/road,/area/rogue/outdoors/bog)
"v" = (/obj/structure/portal,/turf/closed/mineral/rogue/bedrock,/area/rogue/outdoors/bog)
"w" = (/turf/open/floor/rogue/dirt/road,/area/rogue/indoors/cave)
"x" = (/obj/effect/landmark/start/adventurerlate{icon_state = "arrow"; dir = 4},/turf/open/floor/rogue/dirt/road,/area/rogue/outdoors/bog)
"y" = (/turf/open/floor/rogue/hexstone,/area/rogue/outdoors/bog)
"z" = (/obj/effect/landmark/start/adventurerlate{icon_state = "arrow"; dir = 8},/turf/open/floor/rogue/dirt/road,/area/rogue/outdoors/bog)
"A" = (/obj/structure/closet/crate/chest/alchbox,/turf/open/floor/rogue/dirt/road,/area/rogue/indoors/cave)
"B" = (/obj/effect/landmark/events/testportal{aportalloc = "bog"},/turf/open/floor/rogue/dirt/road,/area/rogue/outdoors/bog)
"D" = (/turf/open/floor/rogue/dirt/road,/area/rogue/outdoors/bog)
"G" = (/turf/open/water/swamp,/area/rogue/outdoors/bog)
"Q" = (/turf/closed/mineral/random/rogue/med,/area/rogue/outdoors/bog)
"U" = (/obj/machinery/light/rogue/firebowl/standing,/turf/open/floor/rogue/hexstone,/area/rogue/outdoors/bog)
"V" = (/obj/effect/landmark/mapGenerator/rogue/bog{endTurfX = 128; endTurfY = 128},/turf/closed/mineral/rogue/bedrock,/area/rogue)
"X" = (/obj/effect/landmark/mapGenerator/sunlights{endTurfX = 128; endTurfY = 128},/turf/closed/mineral/rogue/bedrock,/area/rogue/outdoors/bog)
"Z" = (/turf/closed/mineral/rogue/salt,/area/rogue/outdoors/bog)

(1,1,1) = {"
bbbbbbbbbbbbbbbbbbbbbbbbbbbbbbbbbbbbbbbbbbbbbbbbbbbbbbbbbbbbbbbbbbbbbbbbbbbbbbbbbbbbbbbbbbbbbbbbbbbbbbbbbbbbbbbbbbbbbbbbbbbbbbbb
boooooooooossGGGGGGGGGGGGGGGGGGGGGGGGGGGGGGooooooooooooottooooooooooottGGGGGGGGGGGGGGGGGGGGGGGGGGGQQQQQQQGGGGGGGGQQQQQQQQQQQQQob
booooooooooDDDDDDDDDDDDDDDDDDDDDDDDDGGGGGGGGGGGooooooGGGDDGGGGGGGGGGGDDGGGGGGGGGGGGGGGGGGGGDDDDDDDQQQQQQQDDDGGGDDQQQQQQQQQQQQQob
boooooDDDDDDDDDDDDDDDDDDDDDDDDDDDDDGGGDDDDDDDDDDDDDDDGGGDDGGGGDDDDDDDDDDDDDDDGGGGGGGaaaaaGGDDDDDDDQQQQQQQDDDGGGDQQQQQQQQQQQQQQob
boooooaaaaaDDaaaaaaaaaaaaaaaaaaaGGGGGaaaaaaaaaaaaaaaaaGGDDGGGGaaaaaaaDBaaaaaaacaaaaaaaaaGGGaaaaaaaQQQQQQQaaaGGaaQQQQQQQQQQQQQQob
boooeeeGGGaDDaaaaaaGGGGGGGGGGaaaaGaGaaaaaaaaaaaaaaaaaaaaDDaaGGaaaaaaaDDaaaaaaaccaaaaaaaGGGGaaaaQQQQQQQQQQaaaGGaaQQQQQQQQQQQQQQob
boooeeeGGGaDaaaaaaaGGGGGGGGGGaaaaaaGaaaaaaaGGaaaaaaaaaaaDDaaGGaaaaaaaDDaaaaaaaaccccaaaGGGGGaaaaQQQQQQQQQQaaaGGaaQQQQQQQQQQQQQQob
boooeeeeeGaDDaaZaaaGGGGeeGGGGaaaaaaGGaaaaaaGGaGaaaaaaaaaDDaaaaaaaaaaaDDaaaaaaaaccccaaaaaGGGaaaaQQQQQQQQQQaaaGGaaaaaQQQQQQQQQQQob
booDaGeeeGaDDaaaaaGGGeeeeeeGGGaaaaaaaaaaaGGGGaGaaaaaaaaaDaaaaaaaaaaaaDDaaaaaaaaacccaaaaaGGGaaaaQQQQQQQQQQaaaGGaaaaaaQQQQQQQQQQob
booDaGeeeGaaDaaaaaGGGeeeeeeGGGGGaaaaaaaaaaGGGGGaaaaaaaaaDaaaaaaGaaaaaDDaaaaaGaaacccaaaaaGGGaaaaaaQQQQQQQQaaaGaGGaaaaQQQQQQQQQQob
bGDDaGeeeGaaDaaaaaGGGeeeeeeeGGGGaaaaaaaaaaaGGGGaaaaaaaaaDaaaaaaaaGaaaDDaaaaaGaaaaccaaaaaaGGaaaaaaQQQQQQQQaaaGGGGaaaaaaaQQQQQQQob
boDDaGGGeGaaDaaaaaaGGeeeeeeeGGaaaaaaaaaaaaaGGGGGaaaaaaaaDaaaaaaGaGaaaDaaaaaaGaaaacccaaaaaaGaaaaaaQQQQQQQQaaaGGGaaaaaaaaQQQQQQQob
boDDaaGaGGaaDaaaaaaGGeeeeeeeGGaaaaaaGGaaaaaaGGGGaaaaaaaaDaaaaaaGGGGaaDaaaaaaGaaaacccaaaaaGGGaaaaaaQQQQQQaaaaaGGDDDDDDDDDDDDDzGob
boDDaaaaGGaaDaaaaaaGGGGeeeeeGGaaaaaaaGaaaaaaGGGGaaaaaaaaDaaaaaaaGGGaaDaaaaaaGaaaaaccaaGGGGGGaaaaaaaaQQQQaaaaaaGGaaaaaaaaGaGGDGob
booDaaaaaaaaDaaaaaaGGGGGGGeeeGaaaaGGGGaaZaaaaGaGaaaaaaaaDaaaaaaaGGGaaDaaaaGaGaaaaaccaaaaaaGGaaaaaaaaQQQQaaaaaaGGaaaaaaaaGGGDDGob
booDaaaaaaaaDaaaaaaaaaaGGGeeeGaaaaaaaaaaaaaaaGGGaaaaaaaaDaaaaaaaaaaaaDaaaaaaGaGaaacccaaaaaGGaaaaaaaaQQQQaaaaaaGGGaaaaaaaGGGDDGob
bsDDDDDDDDDDDDDDDDaaaaaGGGGeeGaaaaaaaaaaaaaaaGGGaaaaaaaaDaaaaaaaaaaaaDaaaaaaaaGaaaccaaaaaaaGGaaaaaaQQQQQaaaaaaaaGGaaaaaGGGaDDGob
bsDDaaaaaaaaaaaaaDaaaaaaGGGGGGaaaaaaaaaaaaaaaGGGaaaaaaDDDDDDDDDDDDDDDDaaaaaaaaGaaacccaaaaaaGGGaaaaaQQQQQaaaaaaaaGGGaaaaGGaaDGGob
booDaoooooaaaaaaaDaaaaaaaaaaaaaaaaaaaaaaaaaaaGGGaaaaaaaaaaaaaaaaaaaaaDaaaaGGaGGaaccccaaaaGGGaaaaaaaaaQQQaaaaaaaaaGGGaaaGaaaDGGob
boooooooooooooaaaDaaaaaaaaaaaaaaaaaaaaaaaaaaaGGGaaaaaaaaaaaaaaaaaaaaaDaaaaaGGGaaacccccaaaGaaaaaaaaaaaQQQaaaaaaaaGGGGaGaaaaaDGGob
booooooaaaooaaaaaDaaGGGGGGaaaaaaaaaaaaaaaaaaaGGGaaaaaaaaaaaaaaaaaaaaaDaaaaaaaaaaccccaaaaaGaaaaaaaaaaaaaaaaaaaaaaGGGGGaaaaaaDGGob
booooooaaaaaGGGGaDaaGGaaaGGaaaaaaaaaaaaaaaaaaGGGaaaaaaaaaaaaaaaaaaaaaDaGGGGaaaaaccccaaaaaGaaaaaaaaaaaaaaaaaaaaaaGGGGaaaaaaaDGGob
boooooaaaaaaGaaaaDaaaaaaaaaaaaaaaaaaaaaaaaaaaGGGaaaaaaaaaaaaaaaaaaaaaGGGGGaaaaaaaaaccccaaGaaaaaaaaaaaaaaaaaaaaaGGGGaaaaaaaGGGGob
boooooaaaaaaaGGaaDaaaaaaaaaaaGGGGaaaaaaaaaaaaGGGaaGGaGGaaaaaaaaaaaaaGGGGGaaaaaaaaaaccccaaaaaaaaaaaaaaaaaaaaaaaGGGGGaaaaaaaGGGGob
boooooaaZaaaGGaaaDaGGGGGGaGGGGGGGaaaaaaaaaaaaGGaGGaaGGaaaaaaaaaaaaaGGGGaaaaaaaaaaaaaaaaaaaaaaaaaaaaaaaaaaaaaaaGGGGaaaaaaaaGGGGob
boooooaaaaaaGaaaaDaGGeeeeeGGGeGGGaaaaaaaaaGGGaGaaaaaGaaaaaaaaaaaaaGGGDaaaaaaaaaaaaaaaaaaaaaaaaaaaaaaaaaaaaaaaGGGaaaaaaaaaGGGGGob
boooooaaaaaaGaaaaDaGGeeeeeeeeeGGGaaaaaaGGGGaaaaaaaGGGaaaaaaaaaaaaaaaaDaaaaaaaaaaaaaaaaaaaaaaaGGaGGaaaaaaaaaaaaaaaaaaaaaaaGGGGGob
boooooaaaaaaGaaaaDaGGeeeeeeeeeeGGaaaaaaGGaaaaaaaaaGGGGaaaaaGaaaaaaaaaDaaaaaaaaaaaaaaaaaaaaaaaaGGGGGaaaaaaaaaaaaaaaaaaaaaaGGDGGob
boooooaaaaaaaaaaaDaGGGGGeeeeGGGGGaaaaaaaaaGGaaaaaaGGGGGaaaaGaaaaaaaaaDaaaaaaaaaGaaaaaaaaaaaaaaaaGGGGGaaaaaaaaaaaaaaaaaaaGGaDGGob
boooooaaaaaaaaaaaDaaaaaaGGGGGGGGGaaaaaaaaaaGGGaaaaGGGGGaaaaGaaaaaaaaaDaaaaaGGGGaGGaaaaaaaaaaaaaGGGaGGaaaaaaaaaaaaaaaaaaaaaaDGGob
boooooaaaGGaaaaaaDaaaaaaGGGGGaaaaaaaaaaaDDDDDGDDDDDDDDDDDDDGDDDDDDDDDDaaaaGGaaaaGGaaaaaaaaaaaGGGaaaaaaaaaaaaaaaaaaaaaaaaaaaDGGob
boooooaaaaGGaaaaaDaaaaaaaaaaaaaaGGaaaaaaGGGGGGaaaaaaGaaaaaaGaaaaaaaaaaaaaGGaaaaaaGaaaGGGGGGaaGGaaaaaaaaaaaaaaaaaaaaaaaaaaaaDGGob
booooaaaaaaGGaaaaDaGaaaaaaaacaaaaGGaaaaaDaaaaaaaaaaGGaaaaaaaaGaaaaaaaaaaaGGaaaaaaGGaaaaGGaaaGGGGaaaaaaaaaaaaaaaaaaaaaaaaaaaDGGob
booooaaaaaaaGGaaaDaGaaaaaaaacaaaaaGGaaaaDaaaaGGGGGGGGGaaaGGGGaGaaGGGaaaaaGGaaaaaaaGaaaaGaaaaaaaGGGGaaaaaaaaaaaaaaaaaaaaaaaaDGQob
booooaaaaaaaaaaaaDGGaaaaccaacaaaaaaGaaaaDaaaGGGeeeeaeeGaaaGGGaGGGGGGGGGGaaGGGGaaaaaaaaaGaaaaaaaaaaaaaaaaaaaaaaaaaaaaaaaaaaaDGQob
booooooooooaaooooooooooocccacaaaaaaGaaaaDaaaGGeeeeeeeeGaaaGGGaaGGeeGGGGGaaaGGGaaaaaaaaaaaaaaaaaaaaaaaaaaaaaaaaaaaaaaaaaaaaaDQQob
boooooooooooooooooooooooaccaccaaaaGGaaaaDaGGeeeeeeeeeeGGaaaGGaaGGeeGGGGGGeeeGGGGGGGGaaaaaaaaaaQQQaaaaaaaaaaaaaaaaaaaaaaaaaaDQQob
booooaaaaaaaaaaaGGaooooaacccccaaaaGaaaaaDaGGeeeaaaaaeeGGaaaGGaaGGeeeeeGGGGeeeeeGGGGGaaaaaaaaQQQQQQQQQaaaaaaaaaaaaaaaaaaaaaaQQQob
bGDDaaaGGGGGaaaaGDaaaaaaacccccaaaaaaaaaaDaaGeeaaaaaaeeeGaaaaaaaGGeGGeeeeeeeeeeeeeeeGaaaaaQQQQQQQQQQQQQaaaaaaaaaaaaaaaQaaaaaQQQob
bGDDaGGeeeGGGaGGaDaaaaaaaaccccaaaaaaaaaaDaaGeeaaaZaaGeeGGGaaaaaaaaGGGGGeeeeeeeeeeeeGGaaaaQQQQQQQQQQQQQQQQQQQQQQQQQQQQQaaQaQQQQob
beeeeeGeeeGGaaGaaDaaaaaaaacccccaaaaaZaaaDaaGeeaaaaaaaeeGGGaaaaaaaaGGGGGGGeeeeeeeeeeaaaaaaaQQQQQQQQQQQQQQQQQQQQQQQQQQQQQQQQQQQQob
beeeeeeeeGGaaaaaaDaaaaaaaaccccaaaaaGGaaaDaGGGeaaaaaaaeGaGGaaaaaaaaGGGGGGGeeeeeeGGGGGaaaaaaaaQQQQQQQQQQQQQQQQQQQQQQQQQQQQQQQQQQob
bGeeeeeeeGaaaaaaaDaaaaaaaaaaccaaaaaaGaaaDaGGGeeeeeeeeeGGGGGaaaaaaaGGGGGGGaaaGGGGGGaaaaaaaaaaaaQQQQQQQQQQQQQQQQQQQQQQQQQQQQQQQQob
beeeeeGGGaaaaaaaaDaaaaaaaaaaacaaaaaaGGaaDaaGGeeeeeeeeeGGGGGGaaaaaaGGGGGGGaaaaGGGGaaaaaaaaaaaaaaaaaaaaQQQQQQQQQQQQQQaQQaQQQaQQGob
bGGeeeGGaaaaaaaaaDaaaaaaaaaaacaaaaaaaGaaDaaaGGGGGGGGGGaGGGaGaaaDaaaaaaaGaaaaaGGaGGaaaaaaaaaaaaaaaaaaaaaDDDDDDDDDDaaaaaaaaaaQQGob
bGGGGGaaaaaGGGGGaDaaaaaaaaaaacaaaaaaaaaaDaaaaaaaaGGaGaaaaaaGGaaDaaaaaaaaaaaaaaaGGGaaaaaaaaaaaaaaaaaaaaaDaaaaaaaDDDDDDDDDDDDzDGob
bGGDaaaaaaGGaaaaaDaaaaaaaaaaacaaaaaaaaaaDDDDDDDGDDDDDDDDDDDDGGDDDDDDaaaaaaaaaaaGGGaaGGGaaaaaaaaaaaaaaaaDaaaaaaaaaaaaaaaaaaaaaaob
bGGDaaaaaaGaaaaaaDaaaaaaaGaaaaaaGGGGaaaaDaaaaGGaaaaaaaaaaaaaaaaDaaaaaaaaaaaaaaaaaGaaGaGGGGaaaaaaaaaaaaaaaaaaaaaaaaaaaacccccaccob
bGGDaaaaaGGaaaaGGDGGaaaaaaGGGGGaGGGGaaaaDaaaGGaaaaGGGaaaaaaaaaaDaaaaaaaaGGGGGaaaaaaGGaaaaaGaaaaaaaGaaaaaaaaaaaaaaaaaaccccccaccob
bGGDaaaaaGaaaaGGGGGaaaaaaaaaGGGGGGGGaGGaDaaaGGGGGGaaaaaaaaaaaaaDaaaaGGGaGGGGaaaaaaaGaaaaaaaaaaaaaaGGGGaaaaaaaaaaaaaaccccccccccob
bGGDaaaaaaaaaaGGGDGGaaaaaaaaGGeeeeeGGGGGDaaaaaaaaaaaaaaaaaaaaaaDaaaGGGGeeeeGGaaaaaaaaaaaaaaaaaaaaaGGaaaaaaaaaaaaaaacccccccccccob
bGGDaaaaaaaaaGGaaDaGaaaaaaaaGGeeeeeGGGGGaaaaaaaaaaaaaaeeeeaaaaaDaaGGeeeeeeeGGaaaaaaaaaaaaaaaaaaaaaaaaaaaaaaaaaaaacccccooooooccob
bGGDaaaaaaaGGaaaaDGGaaaaaaaaGGeeeeeeGGGaaaaaaaaaaaaaeeeeeeaaaaaDaaGGeeeeeeeeeeGGaaaaaaaaaaaZaaaaaaaaaaaaaaaaaaccccccccjvooojccob
bGGDaaaaaaaaGGaaaDaGaaaaaaaaGGeeeeeeGGGGaaaaaaaaeeeeeeeeeeaaaaaDaaGGeeeeeeeeeeGGaaaaaaaaaaaaaaaaaaaaaaaaaaaaaccccccaaajUyyUjccob
bGGDaaaaaaaGDGDDDDDGDDDDDDDDDaaaGeeeGGGGaaaaeeeeeeeeeeeeaaaaaaaDaaGGGeeeeeeeeeGGZaaaaaaaaaaaaaaaaaaaaaaaaaaaccccccaaaajyyyyjaaob
bGGDaaaaaaaGGGaaaDaGaaaaDDaaaaaaGeeeGGGaaaaaeeeeeeeeaGGaaaaaaaaDaaGGGGGeeeeeeeGGaaaaaaaaaaaaaaaaaaaaaaaaaaaacccccaaaaajyyyyjaaob
bGGDaaaaaaaaGGaaaDGGaaaaDDaaaaaaGeeeGGaaaaaaaGGaaaaaaGaaaaaaaaaDaaGGGGaeeeeeeeGGaaaaaaaaaaaaaaaaaaaaaaaaaaacccccaaaaaaaGaaaaaaob
bGGDaaaaGGaaGGaaaGGGaaaaDDaaaaaaaGGGGGaaaaaGGGaaaaaaGGaaaacaaaaDaaaaGGGGGGGGGGGGaaaaaaaaaaaaaaaaaaaGGaaaaacccccaaaaaGGGaaaaaaaob
bGGDaaaGGaaaGGaaaaaaaaaaDDaaaaaaaaGGGaaaaaGGGGaaaaaaaaaaaccaaaaDaaaaGaaaGGGGGaaaaaaaaaaaaaaaaaaaaaGGGGaaaccccccaaaaGGaaaaaaaaaob
bGGDaaaGGGaaaaaaaaaaaaaaDDaaaaaaaaaaaaaaaGGaaaaaaaaaaaacccaaaaaDaaaaaaaaaaaaaGaGGGGGGGGGaaaaaaGaaGGaGGaGGaaccccaaaaGGaaaaaaaaaob
bDDDaaaaaaaaaaccaccaaaaaaDaaaaaaaaaaaaaaaaaaaaaaaaaaaacccacaaaaDaaaaaaaaaaGGGGaaaGGGaaaaaaaaGGGGGGGGGGaGGaaccccaaaaGGGaaaaaaaaob
bxDDaaaaaaaacccccccccaaaaDaaaaaaaaaaaaaaaaaaaaaaaacccccccccaaaaDaaaaaaaaaaaGGGaGGaaaaaaaaaaaGaaaaaaGGaaaGGGGcccaGGGGGGGGaaaaaaob
baaaaaaaaccccccccccccaaaaDaaaaaaaaaaaaaaaaaaaaaaccacccccccaaaaaDaaaaaGaaaaaaaGGaaaaaaaaaaaaaaaaaaaaGaaaaGGGGGGGGGGGGaaaaaaaaaaob
baaaaaaacccccccccccccccccDaaaaaaaaaaaaaaaaaaaaacacccccccccaaaaaDaaaaGGGaaaaaaGaaaaaaaaaaaGaaaaaaaaaGaaaaGGGGGccaGGGGaaaaaaaaaaob
bccaaaacccccccccccccccaaaDaaaaaaccccccacacacacccccccccccccaaaaGDaGGGGGaaaaaaaaaaaaaaaaaaGGaaaaaaaaaGaaaaGGGGacccaaaaaaaaaaaaaaob
bccccccccccccccccccaaaaaaDacccccccccccccccccccccccccccacaaaaaGGGGGGGaaaaaaaaaaaaaaaaaaaaGaaaaaaaaaaaaaGaaaaaaccccaaaaaaaaaaaaaob
bccccccccccccaaaaaaaaaaaaDaaaaaaaaaaaaaaaaacccaaaaaaaaaaaaaaaGGGaaaaaaaaaaaaaaaaaaaaaaaaaaaaaaaaaaGaaaaaaaaaaccccaaaaaaaaaaGaaob
bccaaaaaaaaaaaaaaaaaaaaaaDaaaaaaaaaaaaaaaaaaaaaaaaaaaaaaaaaaGGGDaaaaaaaaaaaaaaaaaccaaaaaaaaaaaaaaaGGaaaaaacaacccccaaaaaaaaaGaaob
baGGaaaaaaaaaaaaaaaaaaaaaDaaaaaaaaaaaaaaaGaaaaaaaGGaaaaaaaaGGGaDaaaaaaaaaaaaaaaacccaaaaaaaaaZaaaaaGGaaaaaacaacacccaaaaaaaaaGaaob
baGGaaaaaaaaaaaacaaaaaaaaDDDDDDDDDDDDDDGGGDDDDDDDGGDDDDDDDDGGDDDaaaaaaaaaaaaaaacccaacaaaaaaaaaaaaaGGaaaaaacaacaccccaccaaaaaaaaob
baaGGaaaaaaaaaaccaaaaaaaaDaaaaaaaaaaaaaGaaaaaaaaaaGaaaaaaaGGGGaDaaaaaaaaaaaaccccccacaccccccccccaaGGacccccccaaacccccccccaaaaaaaob
bGGGGaaaaaacccccccaaaaaaaDaaaaaaaaaaaaGGaaaaaaaaaaGaaaaaaaGGaGaDaaaaaaaaaaccccccccacaccaccccaaaaaGGaacccccaaaaacccccccccaaaaaaob
bGGGGaaaaaaaacccccaaaaaaaDaaaaaaaaaaaGGaaaaeeeeeeeeeeeeeeaaaaaaDaaaaaaaaaccccccccccaaaaaaaacaaaaaaGaaaaaaaaaaaaacaccccccccaacaob
bGGGaaaaaaaaaaaaaaaaaaaaaDaaaaaaaaaaaGGaaeeeeeeeeeeeeeeeeaaaaaaaaaaaaaacaaccccaccaaaaaaaaaaaaaaaaGGaaaaaaaaaaaaaaaaccaccccaaccob
bGGGaGaaaaaaaaaaaaaaaaaaaaaaaaaaaaaaaaaaaeeeeGaaaaaaaaaGGaaaaaaaaaaaacaacaccccccaaaaaaaaaaaaaaaaaGGaaaaaaaaaaaaaaaaaccccccccccob
bGGDaGaaaaaaaaaaaaaGGGaaaaaaaaaaGGGGaaGGGaaeeeaaaaaaaaaaaaaaaaaaaaaaaaccccccccaaaaaaaaaaaaaaaaaaaaaDDDDDaaaaaaaaaaaaaccaacccccob
bGGDaGaaaaaaaaaaaaGGGaaaaaaaaaaGGGGGGGGaaaeeeeaaaaaaaaaaaaaaaaaaaaccaccccccaaaaaaaaaaaaaaGaGaaaaaaaDDDGDDDDDDDDDDDDDDaaaacccccob
bGGDaGGGGGaaaaaaaGGGGaaaaaaaaGGGaGGGGaaaaaeeaaaaaaaaaaaaaaacacaaaaccccccaaaaaaaGaaaaaaaaaaaaaaaaaaaDDGGGDGaaaaaaaaaaDaaaaaaaccob
bGGDGGaaaGGGaaaaaGGaGaaaaaaaaaaaaaGGGGaaaaaaaaaaccccccccccccccccccccccccaaaaaGGGaaaaGaaaGaaaaaaaaaaDDGGGGGaaaaaaaaaaDaaaaaaaaaob
bGGDGGaaaaaaaaaaaGGaaGaaaaaaaaaaaaaaaGaaaaaaaccccccccccccccccccccccccacaaaaGGGaaaaeeeeeeaaaGaaaaaGaGDGGGGGaaaaaaaaaaDDDDDDDDzGob
bGGGGGaaaaaaaaaaaaaaaGaaaaaaacccaaaaaaaaaaaaaacacacccccccccaaaaccccaaaaaaaaGaaeeeeeeeeeeaaaGaaaaaGaGGGGGGGaaaaaaaaaGaaaaaaGGDGob
bGGGGaaaaaaaaaaaaaaaaaaaaaaacccccccaaaaaaaaaaaaccccaaccccaaaaaaaaaaaaaaaaaaaaaeeeeeeeeeeaaGGaaaGGGaDGGGGGDaaGaaaaaaGGaaaaaGGGGob
bGGDaaaaaaZaaaaaaaaaccaaaaaacccccccccaaaaaaaaaaccaccccaaaaaaaaaaaaaaaaaaaaaaaaeeeeeeeeeeGaGaaaaaGGaaGGGGGDGaaaaaaaaaaaaaaaGGGGob
bGGDaaaaaaaaaaaaaaacccaaaaaacccaaaaaaaaaaaGaaaaaccaaaaaaaaaaaaaaaaaaaaaaGaaaaGeeeeeeeeeeGGaaaaaaGaaaGGGGGDaaGaGaaaaaaaaaaaGGGGob
bGGDaaaaaaaaaaaaacccccaaaaGaaaaaaaaaaaaaaaGaaaaaaaaaaaaGaGGaaaaaaaaaaaaGGaGeeeeeeeeeeeaaaaaaaaaaGaaGGGGGGDaaaGGGGGGaaaaaaaGGGGob
bGGDaaaaaaaaaaaaaccaaaaaaGGGGaaaaaaZaaaaaGGaGaaaaaaaaaaGGGaaaaaaaaaaaaaeeeeeeeeeeaeeGGGaaaaaaaaaGaaGGGGGGDaaaGGaGGGGaaaaaaGGGGob
bGGDaaaaaaaaaaaaaccaaaaaaGGGGaaaaaaaaaaaaGGGGaaaaaaaaaGGaaaaaaaaaaaaaaGeeeeeeeaaaaaaaaGGGaaaaaaaaaaaGGGGDDaaaaGaaaGGaaaaaGGGGGob
bGGDaaaaaaaaaaaaaaaaaaaaaaGGGGaaaaaaaaaaaGGGGaaaaaaaaGGaaaaaaaaaaaaaaaGGGGGGaaaaaaaaaaaaaaGaaaaaaaaaGGGGGDaaaaaaaaGaaaaaaGGDGGob
bGGDaaaaaaaaaaaaaaaaaaaaaaGGGGGaaaGGaaaaaGGGGaaGaaaaaGaaaaaaGGaaaGGaaaGGaGGGaaaaaaaaaaaaaaaaaaaaaaaaDDGGGGaaaaaaaaaaGaaGGGGGGGob
bGGGaaaaaaaaaaaaaaaaZaaaaaaGGaGaaaGGGaGGGGGGGaGGaaaaaGaaaaaGGGaaGGGGGaaaaaaaaaaaaaaaaaaaaaaaaaaaaaaaDGGDGGaaaaaaaaaaGaaGGGGDDGob
bGGGaaGGaaaaaaaaaaaaaaaaaaaaGGGaaaGaGGGGGGGGGGGaaaaaaaaaaaaGeeeeeeeGaaaaaaaaaaaaaaaaaaaaaaaaaaaaaaaaaaaaaaaaaaaaaaaaaGaGaaGGDGob
bGGGaaaGGaGGaGaaaaaaaaaaaaaaaaGGaaGaaaGGaaaGaaaaaaaaaaaaaaaGeeeeeeeGaaaaaaaaaaaaaaaaaaaaaaaaaaaaaaaaaaaaaaaaaaaaaaaaaGGaaaGDDGob
bGGGaaaaGGaGGGaaaaaaaaaaaaaaaaaaaaGaaaGeeeeGaaaaaaaaaaaaaaGGeeeeeeeGGaaaaaaGaaaaaaaaaaaaaaaaaaaaaaaaaaaaaaaaaaaaaaaaaaGaaGGDDGob
bGGGaaaaaGGGGaaaaaaaaaaaaaaaaaaaaGGaaaGeeeeaaaaaaaaaaaaaaaGeeeeeeeeGGGaaaaaGaaaaogggoaaooaaaaaaaaaaaaaaaaaaaaaaaaaaaaaaaaGaDDGob
bGGDaaaaaGGaGGaaaaaaaaaaaaaaaaGaGGaaaaGGeeeaaaaaaccaaaaaaaGeeeeeeeeGGaaaaaaGaaaooggggggggoooaaaaaaaaaaaaaaaaaaaaaaaaaaaaaGGDDGob
bGGGaaaGGaGGGGaaaaaaaaaaaaaaGGGaaaaaaaGGeeeGaaaaaccaaaaaaGGeeeeeeeeeGaaaaaaGaaaooooggggggggggggooaaaaaaaaaaaaaaaaaaaaaaaaGGDDGob
bGDDaaaaGGGaGGaaaaaaaaaaaaaaGGGGaaaaaaGGGeeaaaaacccaaaaaaGGeeeeeeeeeGaaaaaaGGaaaaaoooogggggggggooooaaaaaaaaaaaaaaaaaahhaaGGDDGob
bGDDaaaaaaaaaaaaaaaaaaaaaaaaGGGGGaaaaaaGGeeGaacccccaaaaaGGGeeeeeeeeeGaGaaaaaGaaaaaaaoogggggggggooooaaaaDDaaaaaaaaaaaahhaaGGGGGob
bGDDaaaaaaaaaaaaaaaaaaaaaaaaGeeeeaaaaaaGGeeGaacccccaaaaaaGGeeeeeeeeeGGGaaaaaGaaaaaaaaogggggggggoooooooaDDDDDDDaaaaaaahhaaaaGGGob
bGDDaaaaaaaaaaaaaaaaaaaaaaaaGeeeeGGaaaaGGGGGaaccccccaaaaaaaGGGGGGGGaGGGaaaaaGaaaaaaaaogggggggggoooooooooDDDDDDaaaaaahhhaaaaDDGob
bGDDaaaaaaGaaaaaaaaaaZZaaaaaGGeeeeeGaaaGGGGGaaccccccaaaaaaaaaaaaaaaGGGGGGGaGGaaaaDDDDDgggggggggooooooowwwDDDDDDaaaaahhhaaaaDDGob
bGDDaaaaaaaGGaaaaaaaaaaaaaaaGGeeeeeGaaaaGGGGaaccccccaaaaaaaaaaaaaaaaGGaaGGGaaaaaaDDDDDoogggggggodddwwwwwwggguDDaagaahhhaaaaDDGob
bGDDGGGGaaaaaGaaaaaaaaaaaaaaGGGeeeeGGGaaaaaaaaacccccaaaaaaaaaaaaaaaaGaaaGaaaaaaaowwwwwdogggggggoddwwwwwllggggggggggghhhoooooooob
bGDDaGGGGaaaaaGGGaaaaaaaaaaaGGGeeeeGGGaaaaaaaaccccccaaaaaaaaaaGeeGGGGGaaGGaaaaaaowwwwdddlllllllodwwwwddggggggggggggghhhoooooooob
bGDDaaaaGGGGGaaaGGaaaaaaaaaaaaGeeeeGGGGGaaaaaaccccccaaaaaaaGGGaeeGGaaaaaaaaaaaaadwwwwllllllllllllwwwlllllllllllllllwiiwddddddddb
bGDGGaaaaGaaaaGGGGaaaaaaaaaaaaGGGGGGGGaGaaaaaaccccccaaaaaaGGaGaeeeGaaaaaaGaaaaaodwwwwllllllllllllwwwlllllllllllllllwiiiiwllllldb
bGGGaaGGaGaaaaaaaaaaaaaaaaaaaaGaaaaaGGaaaaaaaaccccccaaaaaGGGGeeeeeGGaaaaaGaaaaagldwwwllllllllllllwwdlllllllllllllllwiiiiwllllldb
bGGGaaaGGGaaaaaaaaaaaaaaGGGGGaaaaaaaaaaaaaGaaaacccccaaaaaGaGGeeeeeGGaaaaaaGaaaagldwwwllllllllllllwwqlllllllllllllllwwiiiwllllldb
bGGGGaaaaaaaaaaaaaaaaGGGGaaaaaaaaaaGaaaaaaGaaaacccccaaaaaGaGGeeeeGaaaaaaaaGGaaaglddwwwlllllllllddwwwlllllllllllllllwiiiidllllldb
bGGGGaaaaaaaaaaaaaGGGGGGaaaaaaaaaaaGaaaaaaGGGaacccccaaaGeeeeeeeeeGaaaaaaaaaGaaagldwwwwddddddddddddiwdddddddddlllllllliillllllldb
bGGGGaaaaaaaaaaaaaaaaaGGGGaaaaaaaaaGGaaaaaaGGaacccccaaaGeeeeeeGGGGaaaaGaaaaaaaoglwrwrwwwwwwdddddddiwwwwwfdddddllllllliillllllldb
bGDGGaaaaaaaaaaaaaaaaaaaGGGaaaaaaaaaGaaaaaaaaaaccaaaaaaGeeeeeeGaGaaaaGGaaaaaaaowwwrwrrwwrrrrrwwwdwiwwwwwwkwAddddllllliillllllldb
bGDGGaaaaaaaaaaaaaaaaaaaaGGGaaaaaaaaGaaaaaaaaaaaaaaaaaaGGGeeeeGGaaaaGGaaaaaaaaodwwrrrrrrrrrrrrwwwwiwwwwwwwwiiiidlllllllllllldddb
bGDDGaaaaaaaaaaaaaaaaaaaaaGaaaaaaaaaaaaaaaaaaaaaaaaaaaaGGGGGGGaaaaaGGaaaaaaaaoodwwwwrrrrrrrrrrwwwdiwwddwwwwiiiidlllllllllllldddb
bGDGGaaGGaaaaaaGGGGGaaaaaaGaaaaaaaaaaaaaaaaaaaaaaaaaaGGaaaaGGaaaaaGGaaaaaaaaDooddddwrrrrrrrrrriiiiiiwddkwwwkddddlllllllllllldddb
bGDGGaaGGaaaaaGGGGGGGGGGaaGaaaaaaaaaaaaaaaaGGaaaaaaaaaGGGGGaaaaaGGaaaaaaaaDDDodwwdddrrrrrrrrrriiiiiiwddfwwwwmdddddlllllllddddddb
bGDDGGGGaaaaaaGGGGGGGGGGaaGaaaaaaaaaaaaaaGGGaaaaaaaaaaaaaaaaaaGGGaaaaaaaaaDDwwwwwwddwrwwwwwrrriiiiiiwwdAwwwwndddldlllllllddddddb
bGxDGGGGaaaaaaaaaaaaaaaaaaGaaaaaaaaaaaGGaGaGaaaaaGGaaaaaaaaaaaaaaaaaaaaaaaaowwwwwwwdllllldwrrriiiiiirwddwwwpiiddlllllllllddddddb
bGDDGGGaaaaaaaaaaaaaaaaaaaaGGaaaaaaaaaaGGGaGGaaaaaGGaaaaaaaaaaaaaaaaaaaaaooodwwwwwwdlllllwwrrriiiiiirwwdwwwiiiddddlllldddddddddb
bGDGGGGaaaaaaaaaaaaaaaaaaaaaaGaaGGGaGGGGGGGaGaaaaaGGGGaaGaaaaaaaaaaaaaaaaoddwwwwdwwwlllllwwrrrrwddirwwkdwwiiiidddddddldddddddddb
bGDGGGGGaaaaaaaaaaaaaaaaaaaaaGGGGGGaGGaaGGGGGaaaaaaGGGGaGGaaaaaaaaaaaaaooodwwwllllwwwwwwwwwrrrrwwiiwwdddkwdddddddddddddddddddddb
bGGGGGGGGaaaaaaaaaaaaaaaaGaGGGGGGGGGGaGGGGGGGaaaaaaaaGGGGGGaaaaaaaaaaaaoddrwwwllllwwwwrrrrrrrrrwdriwwwwwwwdddddddddddddddddddddb
bGGGGDGGGGDDDDDDDDDGGDDDGGGGGGGGDDDDDDDDDGDDDDDDDDDDDDDDGGGGDDDDDDDDDDoodwwwwwlllldddwwwwwwrwwwwddiwwwwwwwiidddddddddddddddddddb
bGGGDDDGGGGGGGGDGGGGGDGGGGGGGDDDDDDDDDDDDDDDDDDDDDDDDDDDDDDGGGDDDDDDDDodwddwwwlllllllldwwddwwwwldwiwddkwfwwAdddddddddddddddddddb
bGGGGGGGGGGGGGGGGGGGGGGGGGGGGGGGGGGGGGGGGGGGGGGGGGGGGGGGGGGGGGGGGGGGGooddllllllllllllllllllllllliiiddddddddddddddddddddddddddddb
VXoooooooooooooooooooooooooooooooooooooooooooooooooooooooooooooooooooooddlllllddlllllllllllllllddddddddddddddddddddddddddddddddb
bbbbbbbbbbbbbbbbbbbbbbbbbbbbbbbbbbbbbbbbbbbbbbbbbbbbbbbbbbbbbbbbbbbbbbbbbbbbbbbbbbbbbbbbbbbbbbbbbbbbbbbbbbbbbbbbbbbbbbbbbbbbbbbb
bbbbbbbbbbbbbbbbbbbbbbbbbbbbbbbbbbbbbbbbbbbbbbbbbbbbbbbbbbbbbbbbbbbbbbbbbbbbbbbbbbbbbbbbbbbbbbbbbbbbbbbbbbbbbbbbbbbbbbbbbbbbbbbb
"}
